Gg,Gg,Gg,Gg,Gg,Gg,Gg,Gg,Gg,Gg,Gg,Gg,Gg,Gg,Gg
Gg,Gg,Ch,Gg,Gg,Gg,Gg,Gg,Gg,Gg,Gg,Gg,Ch,Gg,Gg
Gg,Ch,1 Kh,Ch,Gg,Gg,Gg,Gg,Gg,Gg,Gg,Ch,2 Kh,Ch,Gg
Gg,Ch,Ch,Ch,Gg,Gg,Gg,Gg,Gg,Gg,Gg,Ch,Ch,Ch,Gg
Gg,Gg,Gg,Gg,Gg,Gg,Gg,Gg,Gg,Gg,Gg,Gg,Gg,Gg,Gg
Gg,Gg,Gg,Gg,Gg,Gg,Gg,Gg,Gg,Gg,Gg,Gg,Gg,Gg,Gg
Gg,Gg,Gg,Gg,Gg,Gg,Gg,Gg,Gg,Gg,Gg,Gg,Gg,Gg,Gg
Gg,Gg,Gg,Gg,Gg,Gg,Gg,Gg,Gg,Gg,Gg,Gg,Gg,Gg,Gg
Gg,Gg,Gg,Gg,Gg,Gg,Gg,Gg,Gg,Gg,Gg,Gg,Gg,Gg,Gg
Gg,Gg,Gg,Gg,Gg,Gg,Gg,Gg,Gg,Gg,Gg,Gg,Gg,Gg,Gg
Gg,Gg,Gg,Gg,Gg,Gg,Gg,Gg,Gg,Gg,Gg,Gg,Gg,Gg,Gg
Gg,Gg,Ch,Gg,Gg,Gg,Gg,Gg,Gg,Gg,Gg,Gg,Ch,Gg,Gg
Gg,Ch,3 Kh,Ch,Gg,Gg,Gg,Gg,Gg,Gg,Gg,Ch,4 Kh,Ch,Gg
Gg,Ch,Ch,Ch,Gg,Gg,Gg,Gg,Gg,Gg,Gg,Ch,Ch,Ch,Gg
Gg,Gg,Gg,Gg,Gg,Gg,Gg,Gg,Gg,Gg,Gg,Gg,Gg,Gg,Gg