Mm,Mm,Mm,Mm,Mm,Mm,Mm,Mm,Mm,Mm,Mm,Mm,Mm,Mm,Mm,Mm,Mm,Mm,Mm,Mm,Mm
Mm,Hh,Hh,Hh,Hh,Hh,Hh,Hh,Hh,Hh,Hh,Hh,Hh,Hh,Hh,Hh,Hh,Hh,Hh,Hh,Mm
Mm,Hh,Gg,Ff,Ch,Ch,Ch,Gg,Ff,Gg,Gg,Gg,Gg,Ff,Ch,Ch,Ch,Gg,Ff,Hh,Mm
Mm,Hh,Ff,Gg,Ch,2 Kh,Ch,Ff,Gg,Gg,Gg,Gg,Ff,Gg,Ch,3 Kh,Ch,Ff,Gg,Hh,Mm
Mm,Hh,Gg,Gg,Ch,Ch,Ch,Gg,Gg,Gg,Gg,Ff,Gg,Gg,Ch,Ch,Ch,Gg,Gg,Hh,Mm
Mm,Hh,Gg,Gg,Gg,Ff,Gg,Gg,Gg,Gg,Ff,Gg,Gg,Gg,Gg,Ff,Gg,Gg,Gg,Hh,Mm
Mm,Hh,Gg,Gg,Ff,Gg,Gg,Gg,Gg,Ff,Gg,Gg,Gg,Gg,Ff,Gg,Gg,Gg,Gg,Hh,Mm
Mm,Hh,Gg,Ff,Gg,Gg,Gg,Gg,Hh,Hh,Ww,Hh,Hh,Ff,Gg,Gg,Gg,Gg,Ff,Hh,Mm
Mm,Hh,Ff,Gg,Gg,Gg,Gg,Hh,Gg,Ww,Ww,Ww,Ff,Hh,Gg,Gg,Gg,Ff,Gg,Hh,Mm
Mm,Hh,Ch,Ch,Ch,Gg,Ff,Hh,Ww,Ch,Ch,Ch,Ww,Hh,Gg,Gg,Ff,Ch,Ch,Ch,Mm
Mm,Hh,Ch,1 Kh,Ch,Ff,Gg,Ww,Ww,Ch,7 Kh,Ch,Ww,Ww,Gg,Ff,Gg,Ch,4 Kh,Ch,Mm
Mm,Hh,Ch,Ch,Ch,Gg,Gg,Hh,Ww,Ch,Ch,Ch,Ww,Hh,Ff,Gg,Gg,Ch,Ch,Ch,Mm
Mm,Hh,Gg,Ff,Gg,Gg,Gg,Hh,Ff,Ww,Ww,Ww,Gg,Hh,Gg,Gg,Gg,Gg,Ff,Hh,Mm
Mm,Hh,Ff,Gg,Gg,Gg,Gg,Ff,Hh,Hh,Ww,Hh,Hh,Gg,Gg,Gg,Gg,Ff,Gg,Hh,Mm
Mm,Hh,Gg,Gg,Gg,Gg,Ff,Gg,Gg,Gg,Gg,Ff,Gg,Gg,Gg,Gg,Ff,Gg,Gg,Hh,Mm
Mm,Hh,Gg,Gg,Ch,Ch,Ch,Gg,Gg,Gg,Ff,Gg,Gg,Gg,Ch,Ch,Ch,Gg,Gg,Hh,Mm
Mm,Hh,Gg,Gg,Ch,6 Kh,Ch,Gg,Gg,Ff,Gg,Gg,Gg,Gg,Ch,5 Kh,Ch,Gg,Gg,Hh,Mm
Mm,Hh,Gg,Ff,Ch,Ch,Ch,Gg,Ff,Gg,Gg,Gg,Gg,Ff,Ch,Ch,Ch,Gg,Ff,Hh,Mm
Mm,Hh,Ff,Gg,Gg,Gg,Gg,Ff,Gg,Gg,Gg,Gg,Ff,Gg,Gg,Gg,Gg,Ff,Gg,Hh,Mm
Mm,Hh,Hh,Hh,Hh,Hh,Hh,Hh,Hh,Hh,Hh,Hh,Hh,Hh,Hh,Hh,Hh,Hh,Hh,Hh,Mm
Mm,Mm,Mm,Mm,Mm,Mm,Mm,Mm,Mm,Mm,Mm,Mm,Mm,Mm,Mm,Mm,Mm,Mm,Mm,Mm,Mm
